0,0,0,0,0,0,0,0,0,0,0,0,0,0,0,0,0,0,0,15
0,0,0,0,0,0,0,0,0,0,0,0,0,0,0,0,0,0,0,15
1,1,0,0,0,0,0,0,0,0,0,0,0,0,0,0,0,0,0,15
0,1,1,0,0,0,0,0,0,0,0,0,0,0,0,0,0,0,0,15
0,1,1,0,0,0,0,0,0,0,0,0,0,0,0,0,0,0,15,15
0,0,1,1,0,0,0,0,0,0,0,0,0,0,0,0,0,15,15,0
0,0,0,1,1,0,0,0,0,0,0,0,0,0,0,0,15,15,0,0
0,0,0,0,1,1,0,0,0,0,0,0,0,0,0,15,15,0,0,0
0,0,0,0,0,1,1,0,0,0,0,0,0,0,15,15,0,0,0,0
0,0,0,0,0,0,1,1,0,0,0,0,0,15,15,0,0,0,0,0
0,0,0,0,0,0,0,1,1,0,0,0,0,15,0,0,0,0,0,0
0,0,0,0,0,0,0,1,1,0,0,0,0,15,0,0,0,0,0,0
0,0,0,0,0,0,0,1,1,0,0,0,15,15,0,0,0,0,0,0
0,0,0,0,0,0,0,1,1,0,0,0,15,0,0,0,0,0,0,0
0,0,0,0,0,0,0,0,1,1,0,0,15,0,0,0,0,0,0,0
0,0,0,0,0,0,0,0,0,1,1,0,15,0,0,0,0,0,0,0
0,0,0,0,0,0,0,0,0,0,1,1,15,0,0,0,0,0,0,0
0,0,0,0,0,0,2,0,0,0,0,15,15,0,0,0,0,0,0,0
0,0,0,2,2,2,2,0,0,0,0,15,0,0,0,0,0,0,0,0
2,2,2,2,2,2,2,0,0,0,15,15,0,0,0,0,0,0,0,0
15,15,15,15,15,15,15,0,0,0,15,0,0,0,0,0,0,0,0,0
0,0,0,0,0,0,15,15,15,0,15,0,0,0,0,0,0,0,0,0
0,0,0,0,0,0,0,0,15,15,15,0,0,0,0,0,0,0,0,0
0,0,0,0,0,0,0,0,0,0,0,0,0,0,0,0,0,0,0,0
0,0,0,0,0,0,0,2,2,0,0,0,0,0,0,0,0,0,0,0
0,0,0,0,0,0,2,2,2,2,0,0,0,0,0,0,0,0,0,0
0,0,0,0,0,0,2,2,2,2,0,0,0,0,0,0,0,0,0,0
0,0,0,0,0,0,0,2,2,0,0,0,0,0,0,0,0,0,0,0
